555555555555555555555555555555555555555555
555555555555555555555555555555555555555555
55XXXXXXXXXXXXXXXXXXXXXXXXXXXXXXXXXXXXXX55
55X555555555555551333155599999999999999X55
55X555111111111111333155595555555555559X55
55X5551XXX11XXX151333111195333333333359X55
55X5551XXXXXXXX151333111195333333333359X55
55X5551XXXXXXXX151333155595555555555559X55
55X5551XXXXXXXX151333155599999999999999X55
55X111111111111151333155555555555555555X55
55X1999999999555513331555XXXXXXXXXX5555X55
55X19XXX9XXX9555513331111111111111X5555X55
55X199X99X9X91111133315555XXXXXXX1X5555X55
55X199X99XXX91111133315555XXXXX111X5555X55
55X19XXX9X9X95555133315555XXXXXXX9X5555X55
55X1999999999555513331111999999999X5555X55
55X3333333333335513331555XXXXXXXXXX5555X55
55X333333333333551333155533333333333333X55
55X339999999999551333155533333333333333X55
55X339XXXXXXXX9551333155533XXXXXXXXXXX3X55
55X339XXXXXX999111333111133XXXXXXXXXXX3X55
55X339XXXXXX999111333111133XXXXXXXXXXX3X55
55X339XXXXXXXX9551333155533XXXXX9XXXXX3X55
55X339999999999551333155533333339333333X55
55X333333333333551333155533333339333333X55
55X333333333333551333155555555559555555X55
55X999999999999551111155555555559555555X55
55X999999999999555515555555555559555555X55
55X911111111111111115XXXXXXXX1119111111X55
55X9199XXXXX955555515XXXXXX111119111111X55
55X9199XXXXX955555515XXXXXX111119111111X55
55X9199XXXXX955555115XXXXXXXX1119111111X55
55X919911XXX9555551X5555553999999999999X55
55X9199XXXXX9111111X5555553999999999999X55
55X9199XXXXX91XXXXXX555555333XXXXXXX339X55
55X9199XXXXX91555555555555333XXXXXX9999X55
55X91999999991111111111111333XXXXXXX339X55
55X919999999999999999155553999999999999X55
55X911111111111111119155553999999999999X55
55XXXXXXXXXXXXXXXXXX91XXXXXXXXXXXXXXXXXX55
555555555555555555559155555555555555555555
555555555555555555559155555555555555555555